XXXXXXXXXXXXXXXXXXXXXXXXXXX
XWWWWWWWWWWWWWWWWWWWWWWWWWX
XWFFFFFFFFFFFWFFFFFFFFFFFWX
XWFWFWWFWWWWFWFWWWWFWWWWFWX
XWFWFWWFWWWWFWFWWWWFWWWWFWX
XWFFFFFFFFFFFFFFFFFFFFFFFWX
XWFWWWWFWFWWWWWWWFWFWWWWFWX
XWFFFFFSWFFFFWFFFFWSFFFFFWX
XWWWWWWFWWWWFWFWWWWFWWWWWWX
XWXXXXWFWFFFFFFFFFWFWXXXXWX
XWXXXXWFWFWWWGWWWFWFWXXXXWX
XWWWWWWFWFW0XTX2WFWFWWWWWWX
DDFFFFFFFFWXXTXXWFFFFFFFFDD
XWWWWWWFWFWXX1XXWFWFWWWWWWX
XWXXXXWFWFWWWWWWWFWFWXXXXWX
XWXXXXWFWFFFFPFFFFWFWXXXXWX
XWWWWWWFWWWWFWFWWWWFWWWWWWX
XWFFFFFSWFFFFWFFFFWSFFFFFWX
XWFWWWWFWFWWWWWWWFWFWWWWFWX
XWFFFFFFFFFFFFFFFFFFFFFFFWX
XWFWWWWFWWWWFWFWWWWFWWWWFWX
XWFWWWWFWWWWFWFWWWWFWWWWFWX
XWFFFFFFFFFFFWFFFFFFFFFFFWX
XWWWWWWWWWWWWWWWWWWWWWWWWWX
XXXXXXXXXXXXXXXXXXXXXXXXXXX